//These are the words from GRE word lists which were hard to remember;
//Use Tab to split the different parts 
WordList 2
Anticlimactic	adj.	突减的
Antipathy	n.	反感，厌恶
Antiquarianism	n.	古物研究，好古癖
Antiquated	adj.	陈旧的，过时的
Antiseptic_n	n.	杀菌剂
Antiseptic_adj	adj.	防腐的
Antithesis	n.	对立，相对
Apathetic	adj.	无感情的
Aphorism	n.	格言
Appall	v.	使惊吓，使胆寒
Apportion	v.	（按计划或比例）分配
Apposite	adj.	适当的，贴切的
Apprehensive	adj.	害怕的，敏悟的
Apprise	v.	通知，通告
Approbation	n.	赞许，认可
Apropos	adj./adv.	适当的（地），有关
Aptitude	n.	适宜，才能，资质
Arable	adj.	适于耕种的
Arbiter	n.	权威人士，泰斗
Arboreal	adj.	树木的
Archaeological	adj.	考古学的
Archaic	adj.	古老的
Archetypally	adj.	典型地
Arduous	adj.	费力的，艰难的
Aristocratic	adj.	贵族（化）的
Aromatic	adj.	芳香的，芬芳的
Articulate	v.	清楚地说话，（用关节）连接
Ascetic_adj	adj.	禁欲的
Ascetic_n	n.	苦行者
Ascribe	v.	归因于，归咎于
Assail	v.	质问，攻击
Assertion	n.	断言，声明，主张
Assiduous	adj.	勤勉的，专心的
Assimilate	v.	同化，吸收
Assorted	adj.	各式各样的，混杂的
Astigmatic	adj.	散光的，乱视的
Astray	adj.	迷路的，误入歧途的
Astronomical	adj.	极大的，天文学的
Astute	adj.	机敏的，精明的
Atheist	n.	无神论者
Atonement	n.	弥补
Atrocity	n.	邪恶，暴行
Atrophy	n.	萎缩，衰退
Attribute_v	v.	把…归于
Attribute_n	n.	属性，特质
Attrition	n.	摩擦，磨损
Audacious	adj.	大胆的
Auspices	n.	支持，赞助
Auspicious	adj.	幸运的，吉兆的
Austere	adj.	朴素的
Authentic	adj.	真正的，真实的，可信的
Authoritative	adj.	权威的，官方的，专断的
Avarice	n.	贪婪，贪财
Averse	adj.	反对的，不情愿的
Avid	adj.	渴望的，热心的
Avocational	adj.	副业的，嗜好的
Baffle	v.	使困惑，难倒
Balk_n	n.	梁木，大梁
Balk_v	v.	妨碍，畏缩不前
Banal	adj.	乏味的，陈腐的
Bane	n.	祸根
Banter	n.	打趣，玩笑
Barren	adj.	不育的，贫瘠的，不结果实的
Bashfulness	n.	羞怯
Bask	v.	晒太阳，取暖
Beaded	adj.	以珠装饰的
